4 2
#E####
#    #
# ## #
# ####
#   C#
######