1 0
# #C##E#
# # ## #
# #  # #
# ## # #
# #  # #
# # ## #
#      #
########