1 6
#####E#
#     #
# ### #
#   # #
### # #
#   #C#
# #####